1111111111
1E00000001
1P000C0001
110000C001
1C10000001
1000001001
1000000C01
1C0C0C0C01
10C0C0C0C1
1101010101
1CCCCCCCC1
1111111111
