11111111111111111111111111111111111111111111111111
1E00000000000000C100000000C000100000000000000000P1
11C0000000011111CC000000C0000000100000011000000C01
10000000CCCC00000000CCCC00001000000000011CC0000001
11111111111111111111111111111111111111111111111111
