11111111111111111111111
1P1000000000000000C00E1
11111111111111111111111
