1111111111111111
1000100000000C01
1010001000000001
1011111111111101
1E1P000000000001
1111111111111111
